{
  "tiles": [
    [5, 6, 6, 6, 6, 6, 6, 6, 6, 7],
    [0, 0, 1, 1, 1, 1, 1, 1, 0, 0],
    [0, 0, 1, 1, 1, 1, 3, 1, 0, 0],
    [0, 0, 1, 1, 4, 4, 4, 1, 0, 0],
    [0, 0, 1, 1, 4, 1, 4, 1, 0, 0],
    [0, 0, 1, 2, 1, 1, 1, 1, 0, 0],
    [0, 0, 1, 1, 1, 1, 1, 1, 0, 0],
    [0, 0, 1, 1, 1, 1, 1, 1, 0, 0],
    [0, 0, 1, 1, 1, 1, 1, 1, 0, 0],
    [0, 0, 1, 1, 1, 1, 1, 1, 8, 0]  
  ]
}